00000122300000000000
01222500400000000000
04000000623000000000
04000000004000000000
04000000004000000000
04000000004000000000
04000000004000000000
04000000004000000000
04000000004000000000
0400122222c300000000
06225000125622230000
00000000400000040000
00000000400000040000
00000000400000040000
00000000400000062230
00000000400000000040
00000000622223000040
00000000000004000040
00000000000006222250
00000000000000000000