00000122300000122230
01222500400000400040
04000000627222500040
04000000004000000040
04000000004000000040
04000000004000000040
04000000004000000040
04000000004000000040
04000000004000000040
0400122222c300012250
0A225000125622280000
06230000400000040000
00040000400000040000
01250000400000040000
04000000400000062230
04000000400000000040
04000122922223000040
04000400000004000040
04000400000006222250
06222500000000000000