0000012230
0122250040
0400000040
0400000040
0400000040
0400000040
0400012250
0400040000
0622250000
0000000000